++++++++++++++++++++++++++
++++ ++  +++ ++++  +++++++
   +  +  + +  +++ + ++++++
+  +  +       +      ++ S+
+  +     +    +  +   +   +
+     +++++      +       +
++++++++++++++++++++++++++