++++++++++++++++++++++++++
++++ ++  +++ ++++  +++++++
   +  +  + +  +++ + ++++++
+  +  +       +      ++ S+
+  +     +    +  +   +   +
+     +++++      +   +   +
+  +  +       +          +
+     +       +          +
+++++++++++++++++++++++++++